1111111111111111
10000P0000010001
1110000100100011
1C000E0010100001
1111111111111111
